"a" = (/turf/simulated/floor{icon_state = "cult"; dir = 2},/area/awaymission/labirinth)
"b" = (/turf/simulated/wall/r_wall,/area/awaymission/labirinth)
"c" = (/obj/machinery/door/morgue,/turf/simulated/floor{icon_state = "cult"; dir = 2},/area/awaymission/labirinth)
"d" = (/obj/random/tech_supply,/turf/simulated/floor{icon_state = "cult"; dir = 2},/area/awaymission/labirinth)
"e" = (/mob/living/simple_animal/hostile/blobspore,/turf/simulated/floor{icon_state = "cult"; dir = 2},/area/awaymission/labirinth)
"f" = (/mob/living/simple_animal/hostile/retaliate/clown,/turf/simulated/floor{icon_state = "cult"; dir = 2},/area/awaymission/labirinth)
"g" = (/mob/living/simple_animal/hostile/faithless,/turf/simulated/floor{icon_state = "cult"; dir = 2},/area/awaymission/labirinth)
"h" = (/mob/living/simple_animal/hostile/syndicate/ranged/space,/turf/simulated/floor{icon_state = "cult"; dir = 2},/area/awaymission/labirinth)
"i" = (/mob/living/simple_animal/shade,/turf/simulated/floor{icon_state = "cult"; dir = 2},/area/awaymission/labirinth)
"j" = (/mob/living/simple_animal/hostile/retaliate/malf_drone,/turf/simulated/floor{icon_state = "cult"; dir = 2},/area/awaymission/labirinth)
"k" = (/obj/machinery/door/morgue,/turf/simulated/wall/r_wall,/area/awaymission/labirinth)
"l" = (/mob/living/simple_animal/hostile/creature,/turf/simulated/floor{icon_state = "cult"; dir = 2},/area/awaymission/labirinth)
"m" = (/mob/living/simple_animal/hostile/carp,/turf/simulated/floor{icon_state = "cult"; dir = 2},/area/awaymission/labirinth)
"n" = (/obj/machinery/gateway{tag = "icon-off (NORTHWEST)"; icon_state = "off"; dir = 9},/turf/simulated/floor{icon_state = "cult"; dir = 2},/area/awaymission/labirinth)
"o" = (/obj/machinery/gateway{tag = "icon-off (NORTH)"; icon_state = "off"; dir = 1},/turf/simulated/floor{icon_state = "cult"; dir = 2},/area/awaymission/labirinth)
"p" = (/obj/machinery/gateway{tag = "icon-off (NORTHEAST)"; icon_state = "off"; dir = 5},/turf/simulated/floor{icon_state = "cult"; dir = 2},/area/awaymission/labirinth)
"q" = (/obj/machinery/gateway{tag = "icon-off (WEST)"; icon_state = "off"; dir = 8},/turf/simulated/floor{icon_state = "cult"; dir = 2},/area/awaymission/labirinth)
"r" = (/obj/machinery/gateway/centeraway,/turf/simulated/floor{icon_state = "cult"; dir = 2},/area/awaymission/labirinth)
"s" = (/obj/machinery/gateway{tag = "icon-off (EAST)"; icon_state = "off"; dir = 4},/turf/simulated/floor{icon_state = "cult"; dir = 2},/area/awaymission/labirinth)
"t" = (/obj/machinery/gateway{tag = "icon-off (SOUTHWEST)"; icon_state = "off"; dir = 10},/turf/simulated/floor{icon_state = "cult"; dir = 2},/area/awaymission/labirinth)
"u" = (/obj/machinery/gateway,/turf/simulated/floor{icon_state = "cult"; dir = 2},/area/awaymission/labirinth)
"v" = (/obj/machinery/gateway{tag = "icon-off (SOUTHEAST)"; icon_state = "off"; dir = 6},/turf/simulated/floor{icon_state = "cult"; dir = 2},/area/awaymission/labirinth)
"w" = (/obj/random/tech_supply,/mob/living/simple_animal/hostile/carp,/turf/simulated/floor{icon_state = "cult"; dir = 2},/area/awaymission/labirinth)
"x" = (/obj/random/tech_supply,/mob/living/carbon/slime/pink,/turf/simulated/floor{icon_state = "cult"; dir = 2},/area/awaymission/labirinth)
"y" = (/mob/living/carbon/slime/pink,/turf/simulated/floor{icon_state = "cult"; dir = 2},/area/awaymission/labirinth)
"z" = (/mob/living/carbon/slime/lightpink,/turf/simulated/floor{icon_state = "cult"; dir = 2},/area/awaymission/labirinth)
"A" = (/mob/living/simple_animal/mouse,/turf/simulated/floor{icon_state = "cult"; dir = 2},/area/awaymission/labirinth)
"B" = (/mob/living/simple_animal/crab,/turf/simulated/floor{icon_state = "cult"; dir = 2},/area/awaymission/labirinth)

(1,1,1) = {"
aaaaaaaaaaaaaaaaaaaaaaaaaaaaaaaaaaaaaaaaaaaaaaaaaaaaaaaaaaaaaaaaaaaaaaaaaaaaaaaaaaaaaaaaaaaaaaaaaaaa
aabbbbbbbbbbbbbbbbbbbbbbbbbbbbbbbbbbbbbbbbbbbbbbbbbbbbbbbbbbbbbbbbbbbbbbbbbbbbbbbbbbbbbbbbbbbbbbbbba
aabaacaaaaaaaaaaaaaaaaaaaaaaaaaaaaaaaaaaaaaaaaaaaaaaaaaaaaaaaaadaaaeadaaaacaaaaaaaaaaaaaaaaaaaaaaaba
aabadcdafaaaaaaaaaaaaaaaaaaaaaaaaaaaaaaaaaaaaaaaaaaaaaaaaaaaaaaaaadaaaaaaacaaaaaaaaaaaaaagaaaaaagaba
aabaabbbbbbbbbbbbbbbbbbbbbbbbbbbbbbbbbbbbbbbbbbbbbbbbbbbbbbbbbbbbbbbbbbbbbbbbbbbbbbbbbbbbbbbbbbbccba
aabaabaaaaaabaacaaaaaaaeaaaaaaaaaaaaaaaaaaaaaeaaaaaaacaaaaaaaaaaacaaeaaaaaacaaaaaaaaaaaaaaaaaaabaaba
aabaabaaaaaabaacaaaaaaaaaaaaaaaaaaaaaaaaaaaaaaaadaaaacaaaaaaaaeaacaaaaaaaaacaaaaaaaadaaaaaaadaabaaba
aabdabaaaaaabaabbbbbbbbbbbbbbbbbbbbbbbbbbbbbbbbbbbbbbbbbbbbbbbbbbbbbbbbbbbbbbbbbbbbbbbbbbbbbbccbaaba
aabaabaaaaaabaebaaaaaaaaaaaaaaaaaaaaaaaaabaaaaaaaaaaaaaaaaaaaacaacaaaaaadaaaaaaaaaaaaaaaaaabbaabaaba
aabaabaaaaaabaabaaaaaaaaaaaaaaaaaaaaaaaaabaeaaaaadaaaaaaaaaaaacaecaaaaaaaaaaaaaaaaaaaaaaaaabbaabaaba
aabaabaaaaaabaabaaaaaaaaaaaaaaaaaaaaaaaaabaabbbbbbbbbbbbbbbbbbbaabbbbbbbbbbbbbbbbbbbbbbbbaabbaabaaba
aabaabaaaaaabaabaaaaaaaaaaaaaaaaaaaaaaaaabaabaaaaaaaabbbbaaaaabaababaacaaaaaaaaaaaaaaaaabaabbaabdaba
aabaabaaaaaabaabaaaaaaaaaaaaaaaaaaaaaaaaabaabbbbbbbbbbaabbbbbabeababaacaaaaaaaaaaaaaaaaabaabbaabaaba
aabaabaaaaaabaabaaaaaaaaaaaaaaabbbbbbbbbbbaabbaaaaaaaaaadaaababaababaabbbbbbbbbbbbbbbbccbaabbaabaaba
aabaabaaaaaabaabaaaaaaaaaaaaaaabadaadaaaaaaabbaaaaadaeaaaaaababaababaabbaaaaaaaaaaaaabaabaabbaabaaba
aabaabaaaaaabccbbbbbbbbbbbbaaaabdadaaaaaaaaabbbbbbbbbbaabbbbbabaababhhbbaaaaaaaaaaaaabaabaabbaabagba
aabaabaaaaaabaaeaaaaaaacaabaaaabaabbbbbbbbbbbaaaaaaaabaabaaaaabaababahbbaabbbbaabbbaabaabaabbaabaaba
aabaabaaaaaabaaaaaaaaaacadbaaaabaabaaaaaaaaaaaaaaaaaabaabaaaaabaababaabbaabaabaababaabaabaabbagbaaba
aabaabaaaaaabbbbbbbbbbbbdabaaaabaabaaaaaaaaaaaabbbbaabaabaaaaabaababccbbaabaabaababaabaabaabbaabaaba
aabaabaaaaaaabbbbbbbbbbbccbbbbbbccbaaaaaaaaaaaabaabaabaabaaaaabaababaabbaabaabbbbabaabaabaabbaabaaba
aabaabaaaaaaabaacaeaaaaaaaaaeaaaadbaaaaaaaaaaaabaabaabaabaaaaabaababaabbaabbbbbbbbbaabaabaabbaabaaba
aabaabaaaaaaabaacaaaaeaaaaaaaaaaaabaaaaaaaaaaaabaabaabaabbbbbabaababaabbaabbaaaaaabaabaabaabbaabaaba
aabaabaaaaaaabaabbbbbbbbbbbbbbbbbbbaaaaaaaaaaaabadbaabaabbaababaababaabbaabbaiaaaabaabaabaabbaabaaba
aabaabaaaaaaabccbbbbbbbbbbbbbbbbbbbbbbbbbbbbbbbbccbbbbaabbaabbbccbabaabbaabbccbbccbaabaabaabbaabaaba
aabadbaaaaaaabaaaaaaaaaaaaaaaaaaaaaaaaaaaaaaaaacaacaaaaabbaeaaaaebabaabbaabbaabbaabaabadbaabbaabaaba
aabaabaaaaaaabaaaaaaaeaaaeaaaaaaaaaaaaaaiaaaaaacdacaaaaabbaaaaaaababaabbaabbaabbaabaabaabadbbaabaaba
aabjabaaaaaaabbbbbbbbbbbbbbbbbbbbbbbbbbbbbbbbbbbccbbbbbbbbaabbbaababaabbaabbaabbaabaabaabaabbdabaaba
aabaabaaaaaaaabbbbaaaaaaaaaaaaaaaaaaaaaabbbbaaabaabaaaaaabaababaababaabbaabbaabbaabaabaabaabbaabaaba
aabaabaaaaaaaabadbbbbbbbbbbaaaaaaaaaaaaabaabaaabaabaaaaaabaababaababhhbbaabbaabbaabaabaabaabbaabaaba
aabaabaaaaaaaabadbbagaaaaabaaaaaaaaaaaabbaabbbbbaabbbbbbbbccbbbbbbabhabbaabbaabbaabaabaabaabbaabaaba
aabajbaaaaaaaabaabbaaaaaaabaaaaaaaaaaaabadaaaaaaaaaaaaaaacaacbaaaaabaabbaabbaabbaabaabaabaabbaabaaba
aabaabaaaaaaaabgabbaabbbaabaaaaaaaaaaaabaaaaaaaaaaaaaaaaacaacbaaaaabccbbaabbgabbaabaabaabaabbaabaaba
aabaabaaaaaaaabaabbaababaabaaaaaaaaaaaabbaabbbbbaabbbbbbbbccbbaaaaabaabbaabbaabbaabadbaabaabbaabaaba
aabccbaaaaaaaabaabbaababaabaaaaaaaaaaaaabaabaaabaabaaaaaabaabaaaaaabaabbaabbaabbaacaabaabaabbaabaaba
aabaabbbbbbbbbbaabbaababaabaaaaaaaaaaaaabaabaaabaabaaaaaabaabbbbbaabaabbaabbaabbaacgabaabaabbaabaaba
aabaacadaaaaaaaaaaadababaabaaaaaaaaaaaaabaabaaabaabaaaaaabaabbaabaabaabbaabbaabbbbbbbbaabaabbaabaaba
aabaacaaaaadaaaaaaaaababaabbbbbbbbbbbbbbbaabbbabaabaaaaaabaabbccbbabaabbaabbccbbbbbbbkccbaaacaabaaba
aabaabbbbbccbbbbbbbbbbabaagaaaaaaaaaaaaaaaadababaabaaaaaabdaacaacbabahbbaabbaaaaaaaaaaaabaaacaabaaba
aabaabaaabaabaaaaaaaaaabaaaaaaaaaaaaaaaaaaaaababaabbbbaaabaaacddcbabhhbbaabbaaaaaaaaaaaabbbbbaabaaba
aabaabbbbbbbbbbbbbbbbbbbbbbaabbbbbbbbbbbbaabbbabbbbaabaaabaabbccbbabaabbaabbbbbbbbbbbbbbbbbbbaabaaba
aabaacaaaaaaaaaaaaaaaaabaabaabaaaaaaaabbbaabbbbbbbbadbbbabaabbaabaabaabbaaaaaaaagaaaaaaaaaaaaaabaaba
aabaacdaaadaaaaaaaaadaabaabaabaaaaaaaabaadaaaaadaaaaaaababbbbbaabaabaabbaaaaaaaagaaaaaaaaaaaaadbaaba
aabbbbbbbbccbbbbbccbbccbaabaabaaaaaaaabaaaaaaaaaaaaaaaabaaaaabaabaabccbbbbbbbbbbbbbbbbbbbbbbbbbbccba
aaaaaaaaabaabaaabaabbaabaabaabaaaaaaaabbbaabbbbbbbbaabbbaaaaabaabaabaadaaaadaaaaaaaaaaaaiaaaaaaaaaba
aaaaaaaaabhhbaaabaabbaabaabaabaaaaaaaaaabbbbaaaaaabaabaaaaaaabaabaabaaaaaaaaaaaaaaaaaagaaaaaaaaaaaba
aaaaaaaaabahbaaabaabbaabaabbbbaaaaaaaaaaaabbbbbbbbbccbbbbbbbbbaabbbbbbbbbbbbbbbbbbbbbbbbbbbbbbbbbbba
aaaabbbbbbbbbbbbbbbbbccbbbbaabaaabbbbbbbbabaaaaaaacaacaaaaaaaaaaaaaabaaaaabbbbbbbbbbbbbbaaaaaaaaaaaa
aaaabaaaaaaaadaababacaaaaacaabaaabaaaaaababadaaaaacaacaaaaaaaaaadaaabaaaaabaaaaaaaaaaadbaaaaaaaaaaaa
aaaabaaaaaaaaaaababacaaaaacaabaaabaaaaaababbbbbbbbbccbbbbbbbbbbbbbaabaaaaabaaaaaadaaaaabaaaaaaaaaaaa
aaaabaabbbbbbbaababbbbbbbbbaabaaabbbbbaabaaaaaaaaabaabaaaaaaaaaaabaabaaaaabbbbbbbbbbbaabaaaaaaaaaaaa
bbbbbaabaaaaabaabbbbbbbbbbbaabbbbaaaabaabaaaaaaaaabbbbaaaaaaaaaaabaabaaaaaaaaaaaaaaabaabaaaaaaaaaaaa
badaaaabaaaaabaaaaaaaaaaadbaabaabaaaabaabaaaaaaaaaabbbbbbbaaaaaaabaabbbbbbbbbbbaaaaabaabaaaaaaaaaaaa
baaaaaabaaaaabadaadaaaaaaabaablabaaaabaabbbbbbbbbbbbaaaaabaaaaaaabaacaaaaaacaabaaaaabaabaaaaaaaaaaaa
bbbbbaabaaaaabaabbbbbbbbaabaabaabaaaabaacaaaaamaaaabanopabaaaaaaabaacaaaaaacaabaaaaabaabaaaaaaaaaaaa
aaaabaabbbaaabaabaaaaaabaabaabaabbbbabaacamaaaaaaaabaqrsabaaaaaaabccbbbbbbbbjabaaaaabaabaaaaaaaaaaaa
aaaabaaaabaaabaabaaaaaabaabaabaaclababbbbbccbbbbbbbbatuvabaaaabbbbaabaaaaaabaabbbbbbbccbbbbaaaaaaaaa
aaaabaaaabaaabaabaaaaaabaabaabaacaabaaaaabaabaaaaaabaaaaabaaaabdwbaabaaaaaabaaaaajaacaadaabaaaaaaaaa
aaaabbbaabaaabaabaaaaaabaabccbbbbaabaaaaabaabaaaaaabbadabbaaaabdwbaababbbbbbaaaaaaaacaaaaabbaaaaaaaa
aaaaaabaabbbbbccbbbbbbabaabaaaabbaabaaaaabaabaaaaaaabaaabaaaaabwdbaababaaadbbbbbbbbbbbbbbaabaaaaaaaa
bbbbbbbaabaaacaacaaaababaabaaaabbaabaaaaabaabaaaaaaabadabaaaaabbbbaababadadbaaaaaaaaaaaabaabaaaaaaaa
bdadxbbaabaaacaacaaaababaabbbccbblabaaaaabaabaaaaaaabdadbaaaaaaaabaababaddabaaaaaaaaaaaabaabaaaaaaaa
badydbbadbccbbadbbbccbabaacaaadbbaabaaaaabaabaaaaaaabbcbbaaaaaaaabaababaaaabaaaaaaaaaaaabaabaaaaaaaa
byddabbaabaabbbbbabaababaacaaaabbaabaaaaabaabaaaaaaaababaaaaaaaaabaababbbaabaaaaaaaaaaaabaabbbbaaaaa
bbccbbbaabaabbaababaababbbbbbbbbbaabaaaaabaabaaaaaaaababaaaaaaaaabaabaaabaabaaaaaaaaaaaabaacdabaaaaa
abaabbbbbbaabbaababaabaaaaaabbbbbccbbbbbbbccbbbbbbbbbbcbbbbbbbbbbbccbbbbbccbbbbbbbbbbbbbbaacdabaaaaa
abaaaayaacdabbaababzabaaaaaabaacaaaaaaaaaaaaaaaaaaaaacacaaaadacaacaaaaaaaaaaaaaaaaaaaaaaaaabaabaaaaa
abaayaaazcaabbaababaabbbbbbbbaacaaaaaaaaaamaaaaadaadacacdaaaaacamcaaaaaaaaaaaaaaaaaaaaaaaaabaabaaaaa
abbbbbbbbbbbbbaababzacaaayyacaabbbbbbbbbbbbbbbccbbbbbbbbbbbbbbkccbbbbbbbbbaAbbbbbbbbbbbbbbbbaabaaaaa
aaaaaaaaaaaaabaababaacaaaaaacaabaaaaaaaaaaaaabadcaaaaacaabaaaabaabaaaaaaabaababbbbaaaaaaaaabaabaaaaa
bbbbbbbbbaaaabaababbbbbbbbbbbadbaaaaaabbbbbbbbaacadaaacdabaaaabaabaaaaaaabaababdabbbbbbbbbabaabbbbaa
baaazaaabbbbbbaabbbbbaaaaaaabaabaaaaaabaaaaaaaaabbbbbbkaabaaaabaabaaaaaaabaababadaaaaaaaababaaaaabaa
bazaaaadbbaabbaacaaabaaaaaaabaabaaaaaabaaaaaaaaabmmmmmbaabaaaabaabaabbbbbbaababdaaaaaaaaababaaaiabaa
baabbbaabbaabbaacaaabbbbbbbbbaabaaaaaabaabbbbbbbbmmmmmbaabaaaabaabaabaadaaaababadbbbbbbdababbbbaabaa
baababaybbaabbbbbbccbaaaaaaacaabaaaaaabaabbbbbbbbbbbbbbaabbbbbbaabaabaaaaaaababbbbaaaabaabaaaabaabaa
baababaabbadbaaaabaabaaazaaacaabaaaaaabaaaaaaaaaaaaaaaaadaaaaaaaabaabbbbbbbbbbbbbbbbbbbaabbbbbbaabaa
baababaabbccbbbbbbaabbbbbbbbbaabaaaaaabaaaaaaaaaaaaaaaaaaaaaaaaiabaaaaaaaaaabjaaaaaaaacaabbaabbaabaa
byabbbaabbaaaacaacaabaaaaaaabaabaaaaaabbbbbbbbbbbbbaabbaabbbbbbaabaaaaaaaaaabaaaaajaaacaabbaabbaabaa
baaaabaybbaaaacaacaabaaaaaaabaabaaaabbbbaaaaaaaaaabaabbaabaaaabaabaaaaaaaaaabccbbbbbbbbbbbbaabbaabaa
baadabccbbbbbbbccbbbbbbbbbbbbaabaaaabaabbbbbbbbbbbbaabbaabaaaabaabaaaaaaaaaabaabaaaaaaaaabbaabbaabaa
bbbccbaaaaabaabaabaaabaaaaaacaababbbbaabaaaaaamaaaaaabbaabaaaabaabaaaaaaaaaabaabbbbbbbbbbbbaabbaabaa
aabaabaaaaabaabaabaaabaazaaacaababaabaabaadaaaaaadaaabbaabbbbbbaabaaaaaaaaaabaabaaaaaaaaaacaabbaabaa
aabaabbbbccbaabaabaaabaabbbbbbbbbbaabaabaabbbbbbbbbbbbbaacaaabbaabaaaaaaaaaabaabaaaaaadaaacaabbaabaa
aabdabaabaabaabadbaaabaabaaaabaadaaabaabaabaaaaaaaaaaabaacaaabbaabbbbbbbbbbbbaabbbbbbaabbbbaabbaabaa
aabaabaabaabaabaabaaabaabaaaabaaaaaabaabaabaaaaaaaaaaabaabbdabbaacaaAaacdaaaaaabaaaabaabaabaabbaabaa
aabaabaabdabaabaabaaabdabaaaabaabbaabaabaabaaaaaaaaaaabaabbaabbaacaaaaacaaaaaaabaaaabaabaabaabbaabaa
aabaabaabaabaabaabaaabaabaaaablabbaabaabaabaaaaaaaaaaabaabbaabbaabbbbccbbbbbbbbbbbbbbaabaabaabbaabaa
aabaabaabaabaabaabaaabaabaaaabaabbaabbbbaabbbbbbbbbbbbbccbbccbbaabaabaabbbbbbaaaaBaacaabaabaabbaabaa
aabaabaabazbaabazbaaabaabaaaabaabbaaaaaaamaaaaaaaaaaaaaaaacaabbaabaabaaaaaaacaaaaaaacaabaabaabbaabaa
aabaabaabaabaabaabaaabaabaaaabaabbaaaaaaaaaaaaaaaaadaaaaaacmabbaabaabaaaaaaacaabbbbbbbbbaabaabbaabaa
aabccbbbbccbbbbccbbbbbccbbbbbkccbbbbbbbbbbbbbbbbbbbbbbbbbbbccbbaabaabbbbbbbbbccbabbbbbbbbbbccbbaabaa
aabaaaaaaadaaaaazaaaacaazaaaaaaaaaaaaaaaabaabbbbbbbbbbbbaabaabbaabaaaaaaaaaabaababaaaaaaaaadabbaabaa
aabaaaaaaaaaaaaaaaaaacaaaaaaaaaaadaaaaaaabaabaaaaaaaamabaabaabbaAbbbbbbbbbbbbaababaaaaaBaaaaabbaabaa
aabbbbbbbbbbbbbbbbbbbbbbbbbbbbbbbbbbbbbccbaabaaaaaaaaaabaabaabbaaaaaaaaaaaaaaaababccbbbbbbbbbbbaabaa
aaaaaaaaaaaaaaaaaaaaaaaaaaaaaaaaaaaaaabaabaakccbbbbbbccbaabaabbaaaaaaaaaaaaadaababaabbbbbbbbbbbaabaa
aaaaaaaaaaaaaaaaaaaaaaaaaaaaaaaaaaaaaabaabbbbaabaaaabaabaabaabbbbbbbbbbbbbbbbbbbabaacaaaaaaaaaaaabaa
aaaaaaaaaaaaaaaaaaaaaaaaaaaaaaaaaaaaaabaaaaaaadbaaaabaabaabaabaaaaabbbbbbbbaaaaaabaacaaaaadaaaaaabaa
aaaaaaaaaaaaaaaaaaaaaaaaaaaaaaaaaaaaaabaaaaaaaabaaaabaabbbbccbbbbbbbaaaadabbbbbbbbccbbbbbbbbbbbbbbaa
aaaaaaaaaaaaaaaaaaaaaaaaaaaaaaaaaaaaaabbbbbbbbbbaaaabaacaaamaaaaaaacaaaBaaaaaaaaaaaabaaaaaaaaaaaaaaa
aaaaaaaaaaaaaaaaaaaaaaaaaaaaaaaaaaaaaaaaaaaaaaaaaaaabaacaaaaaaaadaacaabbaaaaaaaaaaaabaaaaaaaaaaaaaaa
aaaaaaaaaaaaaaaaaaaaaaaaaaaaaaaaaaaaaaaaaaaaaaaaaaaabbbbbbbbbbbbbbbbbbbbbbbbbbbbbbbbbaaaaaaaaaaaaaaa
"}
